#################
#..............a#
#.####.###.####.#
#.#b.........g#.#
#.#.####.####.#.#
#.#.#e.....d#.#.#
#...#.#####.#...#
#.#.#f.....c#.#.#
#.#.####.####.#.#
#.#g.........b#.#
#.####.###.####.#
#a.............a#
#################